mai châu|m.châu	hòa bình|h.bình
quận 5|5|q5	hồ chí minh|hcm
cầu kè|c.kè	trà vinh|t.vinh
ứng hòa|ứ.hòa|ứh	hà nội|hn
hòa an|h.an	cao bằng|c.bằng
bắc ninh|b.ninh	bắc ninh|b.ninh
thống nhất|t.nhất	đồng nai|đ.nai
lai châu|l.châu	lai châu|l.châu
quận 8|8|q8	hồ chí minh|hcm
lang chánh|l.chánh	thanh hóa|t.hóa
đống đa|đ.đa|đđ	hà nội|hn
thới lai|t.lai	cần thơ|c.thơ
bố trạch	quảng bình|q.bình
đắk tô|đ.tô	kon tum|k.tum
hai bà trưng|h.b.trưng|hbt	hà nội|hn
trạm tấu|t.tấu	yên bái|y.bái
dĩ an	bình dương|b.dương
phú quốc|p.quốc	kiên giang|k.giang
phước sơn|p.sơn	quảng nam|q.nam
đức linh|đ.linh	bình thuận|b.thuận
hải lăng|h.lăng	quảng trị|q.trị
buôn hồ|b.hồ	đắk lắk|đ.lắk
thái bình|t.bình	thái bình|t.bình
ninh bình|n.bình	ninh bình|n.bình
đăk pơ|đ.pơ	gia lai|g.lai
quận 3|3|q3	hồ chí minh|hcm
phúc thọ|p.thọ|pt	hà nội|hn
krông pa|k.pa	gia lai|g.lai
bá thước	thanh hóa|t.hóa
đông hòa|đ.hòa	phú yên|p.yên
an phú	an giang
tuyên hóa|t.hóa	quảng bình|q.bình
phú bình|p.bình	thái nguyên|t.nguyên
xuân trường|x.trường	nam định|n.định
bà rịa	bà rịa vũng tàu|bà rịa|vũng tàu|b.rịa v.tàu
bắc sơn|b.sơn	lạng sơn|l.sơn
tuy hòa|t.hòa	phú yên|p.yên
đông giang|đ.giang	quảng nam|q.nam
long biên|l.biên|lb	hà nội|hn
yên mỹ|y.mỹ	hưng yên|h.yên
thanh xuân|t.xuân|tx	hà nội|hn
hải châu|h.châu|hc	đà nẵng|đn
mường tè|m.tè	lai châu|l.châu
cái răng|c.răng	cần thơ|c.thơ
hoàng su phì|h.s.phì	hà giang|h.giang
đồng văn|đ.văn	hà giang|h.giang
đồng xuân|đ.xuân	phú yên|p.yên
hòa bình|h.bình	hòa bình|h.bình
thuận châu|t.châu	sơn la
cao lộc|c.lộc	lạng sơn|l.sơn
yên thành|y.thành	nghệ an
tân thành|t.thành	bà rịa vũng tàu|bà rịa|vũng tàu|b.rịa v.tàu
mai sơn|m.sơn	sơn la
can lộc|c.lộc	hà tĩnh|h.tĩnh
yên bái|y.bái	yên bái|y.bái
sìn hồ|s.hồ	lai châu|l.châu
mỹ xuyên	sóc trăng|s.trăng
yên bình|y.bình	yên bái|y.bái
đà lạt	lâm đồng|l.đồng
gò công tây|g.c.tây	tiền giang|t.giang
bình thủy|b.thủy	cần thơ|c.thơ
sông hinh|s.hinh	phú yên|p.yên
krông bông|k.bông	đắk lắk|đ.lắk
phổ yên|p.yên	thái nguyên|t.nguyên
an lão|al	hải phòng|hp
gò quao	kiên giang|k.giang
krông a na|k.a.na	đắk lắk|đ.lắk
thanh oai|t.oai|to	hà nội|hn
trà lĩnh|t.lĩnh	cao bằng|c.bằng
mường ảng|m.ảng	điện biên|đ.biên
thanh sơn|t.sơn	phú thọ|p.thọ
cái nước|c.nước	cà mau|c.mau
đô lương	nghệ an
hưng hà|h.hà	thái bình|t.bình
tân trụ|t.trụ	long an|l.an
hòa bình|h.bình	bạc liêu|b.liêu
cẩm thủy|c.thủy	thanh hóa|t.hóa
tánh linh|t.linh	bình thuận|b.thuận
nam trực|n.trực	nam định|n.định
phú thiện|p.thiện	gia lai|g.lai
mường nhé|m.nhé	điện biên|đ.biên
gò dầu	tây ninh|t.ninh
trực ninh|t.ninh	nam định|n.định
phước long|p.long	bạc liêu|b.liêu
châu thành|c.thành	bến tre|b.tre
bình minh|b.minh	vĩnh long|v.long
nam sách|n.sách	hải dương|h.dương
long khánh|l.khánh	đồng nai|đ.nai
hiệp đức|h.đức	quảng nam|q.nam
tây sơn|t.sơn	bình định|b.định
bình giang|b.giang	hải dương|h.dương
hồng ngự|h.ngự	đồng tháp|đ.tháp
thái hòa|t.hòa	nghệ an
thủy nguyên|t.nguyên|tn	hải phòng|hp
hải dương|h.dương	hải dương|h.dương
con cuông|c.cuông	nghệ an
quận 11|11|q11	hồ chí minh|hcm
đồng xoài|đ.xoài	bình phước|b.phước
cai lậy|c.lậy	tiền giang|t.giang
đắk song|đ.song	đắk nông|đ.nông
lâm thao|l.thao	phú thọ|p.thọ
hạ lang	cao bằng|c.bằng
long phú|l.phú	sóc trăng|s.trăng
thạnh phú|t.phú	bến tre|b.tre
giao thủy|g.thủy	nam định|n.định
u minh	cà mau|c.mau
bắc tân uyên|b.t.uyên	bình dương|b.dương
gia viễn|g.viễn	ninh bình|n.bình
chư păh|c.păh	gia lai|g.lai
gò công	tiền giang|t.giang
trà ôn|t.ôn	vĩnh long|v.long
long mỹ|l.mỹ	hậu giang|h.giang
vũng tàu|v.tàu	bà rịa vũng tàu|bà rịa|vũng tàu|b.rịa v.tàu
đồng phú|đ.phú	bình phước|b.phước
thái thụy|t.thụy	thái bình|t.bình
cư m'gar	đắk lắk|đ.lắk
ninh hải|n.hải	ninh thuận|n.thuận
tân sơn|t.sơn	phú thọ|p.thọ
tân hồng|t.hồng	đồng tháp|đ.tháp
tu mơ rông|t.m.rông	kon tum|k.tum
lộc ninh|l.ninh	bình phước|b.phước
nghĩa đàn|n.đàn	nghệ an
bảo lâm|b.lâm	cao bằng|c.bằng
phú lương|p.lương	thái nguyên|t.nguyên
trà cú|t.cú	trà vinh|t.vinh
lai vung|l.vung	đồng tháp|đ.tháp
đại lộc|đ.lộc	quảng nam|q.nam
tiên phước|t.phước	quảng nam|q.nam
từ liêm|nam từ liêm|tl|ntl	hà nội|hn
đa krông	quảng trị|q.trị
châu thành|c.thành	hậu giang|h.giang
sốp cộp|s.cộp	sơn la
hải an|h.an|ha	hải phòng|hp
yên mô|y.mô	ninh bình|n.bình
lạc sơn|l.sơn	hòa bình|h.bình
m'đrắk	đắk lắk|đ.lắk
điện biên phủ|đ.b.phủ	điện biên|đ.biên
cái bè|c.bè	tiền giang|t.giang
ayun pa|a.pa	gia lai|g.lai
thanh miện|t.miện	hải dương|h.dương
tĩnh gia|t.gia	thanh hóa|t.hóa
cù lao dung|c.l.dung	sóc trăng|s.trăng
nha trang|n.trang	khánh hòa|k.hòa
hoành bồ|h.bồ	quảng ninh|q.ninh
sông công|s.công	thái nguyên|t.nguyên
đắk hà|đ.hà	kon tum|k.tum
cát hải|c.hải|ch	hải phòng|hp
hải hậu|h.hậu	nam định|n.định
thiệu hóa|t.hóa	thanh hóa|t.hóa
như xuân|n.xuân	thanh hóa|t.hóa
krông nô|k.nô	đắk nông|đ.nông
đà bắc	hòa bình|h.bình
quỳnh nhai|q.nhai	sơn la
bạc liêu|b.liêu	bạc liêu|b.liêu
mang thít|m.thít	vĩnh long|v.long
tuyên quang|t.quang	tuyên quang|t.quang
uông bí|u.bí	quảng ninh|q.ninh
quốc oai|q.oai|qo	hà nội|hn
nam giang|n.giang	quảng nam|q.nam
điện biên|đ.biên	điện biên|đ.biên
mộc châu|m.châu	sơn la
bắc mê|b.mê	hà giang|h.giang
ngân sơn|n.sơn	bắc kạn|b.kạn
thạnh hóa|t.hóa	long an|l.an
tiên lãng|t.lãng|tl	hải phòng|hp
quảng yên|q.yên	quảng ninh|q.ninh
minh long|m.long	quảng ngãi|q.ngãi
phụng hiệp|p.hiệp	hậu giang|h.giang
móng cái|m.cái	quảng ninh|q.ninh
phú thọ|p.thọ	phú thọ|p.thọ
bình xuyên|b.xuyên	vĩnh phúc|v.phúc
ninh giang|n.giang	hải dương|h.dương
hàm tân|h.tân	bình thuận|b.thuận
la gi	bình thuận|b.thuận
sông mã|s.mã	sơn la
tư nghĩa	quảng ngãi|q.ngãi
châu thành|c.thành	trà vinh|t.vinh
quế võ|q.võ	bắc ninh|b.ninh
cam lâm|c.lâm	khánh hòa|k.hòa
nhà bè|n.bè|nb	hồ chí minh|hcm
thạch thất|t.thất|tt	hà nội|hn
quận 1|1|q1	hồ chí minh|hcm
tiên du|t.du	bắc ninh|b.ninh
hoài nhơn|h.nhơn	bình định|b.định
ia pa	gia lai|g.lai
đắk r'lấp	đắk nông|đ.nông
vĩnh long|v.long	vĩnh long|v.long
tuy an|t.an	phú yên|p.yên
lê chân|lc	hải phòng|hp
cư kuin	đắk lắk|đ.lắk
đồng hỷ|đ.hỷ	thái nguyên|t.nguyên
mỹ hào	hưng yên|h.yên
mường khương|m.khương	lào cai|l.cai
xín mần|x.mần	hà giang|h.giang
gia nghĩa|g.nghĩa	đắk nông|đ.nông
ba tơ	quảng ngãi|q.ngãi
đạ huoai	lâm đồng|l.đồng
phú nhuận|p.nhuận|pn	hồ chí minh|hcm
ô môn	cần thơ|c.thơ
pác nặm|p.nặm	bắc kạn|b.kạn
đông hải|đ.hải	bạc liêu|b.liêu
lục ngạn|l.ngạn	bắc giang|b.giang
lập thạch|l.thạch	vĩnh phúc|v.phúc
rạch giá|r.giá	kiên giang|k.giang
lâm hà|l.hà	lâm đồng|l.đồng
cầu ngang|c.ngang	trà vinh|t.vinh
nghi lộc|n.lộc	nghệ an
hàm thuận bắc|h.t.bắc	bình thuận|b.thuận
hưng nguyên|h.nguyên	nghệ an
đông hà|đ.hà	quảng trị|q.trị
quy nhơn|q.nhơn	bình định|b.định
thanh chương|t.chương	nghệ an
nam trà my|n.t.my	quảng nam|q.nam
kiến xương|k.xương	thái bình|t.bình
sông lô|s.lô	vĩnh phúc|v.phúc
hoàn kiếm|h.kiếm|hk	hà nội|hn
đức thọ|đ.thọ	hà tĩnh|h.tĩnh
triệu phong|t.phong	quảng trị|q.trị
kỳ sơn	hòa bình|h.bình
lộc bình|l.bình	lạng sơn|l.sơn
long hồ|l.hồ	vĩnh long|v.long
tân phú|t.phú|tp	hồ chí minh|hcm
lâm bình|l.bình	tuyên quang|t.quang
sa thầy	kon tum|k.tum
chư prông|c.prông	gia lai|g.lai
tam đường|t.đường	lai châu|l.châu
mường lay|m.lay	điện biên|đ.biên
hòn đất|h.đất	kiên giang|k.giang
chợ mới|c.mới	bắc kạn|b.kạn
việt yên|v.yên	bắc giang|b.giang
sơn hà|s.hà	quảng ngãi|q.ngãi
thủ dầu một|t.d.một	bình dương|b.dương
thanh hà|t.hà	hải dương|h.dương
vụ bản	nam định|n.định
chợ lách|c.lách	bến tre|b.tre
bình đại|b.đại	bến tre|b.tre
gia lộc|g.lộc	hải dương|h.dương
quảng xương|q.xương	thanh hóa|t.hóa
vũng liêm|v.liêm	vĩnh long|v.long
nguyên bình|n.bình	cao bằng|c.bằng
phù mỹ|p.mỹ	bình định|b.định
tân an|t.an	long an|l.an
thanh hóa|t.hóa	thanh hóa|t.hóa
khánh vĩnh|k.vĩnh	khánh hòa|k.hòa
định quán|đ.quán	đồng nai|đ.nai
tân uyên|t.uyên	lai châu|l.châu
bù đăng	bình phước|b.phước
phú ninh|p.ninh	quảng nam|q.nam
hà tiên	kiên giang|k.giang
thuận thành|t.thành	bắc ninh|b.ninh
tịnh biên|t.biên	an giang
hữu lũng|h.lũng	lạng sơn|l.sơn
châu thành|c.thành	long an|l.an
quận 2|2|q2	hồ chí minh|hcm
na hang	tuyên quang|t.quang
châu thành|c.thành	tiền giang|t.giang
tây hồ|t.hồ|th	hà nội|hn
thạch an|t.an	cao bằng|c.bằng
thuận bắc|t.bắc	ninh thuận|n.thuận
tháp mười|t.mười	đồng tháp|đ.tháp
chợ đồn|c.đồn	bắc kạn|b.kạn
anh sơn|a.sơn	nghệ an
trảng bom|t.bom	đồng nai|đ.nai
châu thành|c.thành	đồng tháp|đ.tháp
cao lãnh|c.lãnh	đồng tháp|đ.tháp
hòa thành|h.thành	tây ninh|t.ninh
chiêm hóa|c.hóa	tuyên quang|t.quang
cao phong|c.phong	hòa bình|h.bình
đức hòa|đ.hòa	long an|l.an
dương kinh|d.kinh|dk	hải phòng|hp
thủ thừa|t.thừa	long an|l.an
sông cầu|s.cầu	phú yên|p.yên
hạ long	quảng ninh|q.ninh
long điền|l.điền	bà rịa vũng tàu|bà rịa|vũng tàu|b.rịa v.tàu
duy tiên|d.tiên	hà nam|h.nam
thanh khê|t.khê|tk	đà nẵng|đn
quỳnh lưu|q.lưu	nghệ an
tam nông|t.nông	phú thọ|p.thọ
lương tài|l.tài	bắc ninh|b.ninh
kỳ sơn	nghệ an
ninh sơn|n.sơn	ninh thuận|n.thuận
chư pưh|c.pưh	gia lai|g.lai
bắc kạn|b.kạn	bắc kạn|b.kạn
ba chẽ	quảng ninh|q.ninh
bát xát|b.xát	lào cai|l.cai
thường xuân|t.xuân	thanh hóa|t.hóa
diên khánh|d.khánh	khánh hòa|k.hòa
thới bình|t.bình	cà mau|c.mau
năm căn|n.căn	cà mau|c.mau
sơn hòa|s.hòa	phú yên|p.yên
võ nhai	thái nguyên|t.nguyên
bảo thắng|b.thắng	lào cai|l.cai
mèo vạc|m.vạc	hà giang|h.giang
vân canh|v.canh	bình định|b.định
đơn dương|đ.dương	lâm đồng|l.đồng
tuy phước|t.phước	bình định|b.định
tứ kỳ	hải dương|h.dương
ninh phước|n.phước	ninh thuận|n.thuận
đông sơn|đ.sơn	thanh hóa|t.hóa
phan rang-tháp chàm|p.rang-t.chàm|phan rang-t.chàm	ninh thuận|n.thuận
bến lức|b.lức	long an|l.an
vĩnh hưng|v.hưng	long an|l.an
hà trung	thanh hóa|t.hóa
tân phước|t.phước	tiền giang|t.giang
di linh	lâm đồng|l.đồng
sa pa	lào cai|l.cai
bắc quang|b.quang	hà giang|h.giang
tuy phong|t.phong	bình thuận|b.thuận
tân kỳ|t.kỳ	nghệ an
đức trọng|đ.trọng	lâm đồng|l.đồng
bình thạnh|b.thạnh|bt	hồ chí minh|hcm
quận 9|9|q9	hồ chí minh|hcm
định hóa|đ.hóa	thái nguyên|t.nguyên
cần giờ|c.giờ|cg	hồ chí minh|hcm
giang thành|g.thành	kiên giang|k.giang
hoàng mai|h.mai|hm	hà nội|hn
yên sơn|y.sơn	tuyên quang|t.quang
bảo yên|b.yên	lào cai|l.cai
mường chà|m.chà	điện biên|đ.biên
thăng bình|t.bình	quảng nam|q.nam
đắk mil|đ.mil	đắk nông|đ.nông
mỏ cày nam|m.c.nam	bến tre|b.tre
hớn quản|h.quản	bình phước|b.phước
bảo lâm|b.lâm	lâm đồng|l.đồng
quảng ngãi|q.ngãi	quảng ngãi|q.ngãi
đình lập|đ.lập	lạng sơn|l.sơn
vị thanh	hậu giang|h.giang
bình gia|b.gia	lạng sơn|l.sơn
vân đồn|v.đồn	quảng ninh|q.ninh
thanh ba|t.ba	phú thọ|p.thọ
phú xuyên|p.xuyên|px	hà nội|hn
phú hòa|p.hòa	phú yên|p.yên
phước long|p.long	bình phước|b.phước
kế sách	sóc trăng|s.trăng
mê linh|ml	hà nội|hn
chư sê|c.sê	gia lai|g.lai
tây hòa|t.hòa	phú yên|p.yên
thoại sơn|t.sơn	an giang
bỉm sơn|b.sơn	thanh hóa|t.hóa
đông hưng|đ.hưng	thái bình|t.bình
đông anh|đ.anh|đa	hà nội|hn
việt trì|v.trì	phú thọ|p.thọ
mộc hóa|m.hóa	long an|l.an
trùng khánh|t.khánh	cao bằng|c.bằng
duy xuyên|d.xuyên	quảng nam|q.nam
cư jút	đắk nông|đ.nông
mỹ tho	tiền giang|t.giang
kiến tường|k.tường	long an|l.an
phục hòa|p.hòa	cao bằng|c.bằng
tiên lữ|t.lữ	hưng yên|h.yên
bù đốp	bình phước|b.phước
vĩnh cửu|v.cửu	đồng nai|đ.nai
yên lập|y.lập	phú thọ|p.thọ
mỹ lộc	nam định|n.định
ninh kiều|n.kiều	cần thơ|c.thơ
bình chánh|b.chánh|bc	hồ chí minh|hcm
lục yên|l.yên	yên bái|y.bái
tân bình|t.bình|tb	hồ chí minh|hcm
kông chro|k.chro	gia lai|g.lai
cần giuộc|c.giuộc	long an|l.an
trần văn thời|t.v.thời	cà mau|c.mau
xuyên mộc|x.mộc	bà rịa vũng tàu|bà rịa|vũng tàu|b.rịa v.tàu
ba đình|bđ	hà nội|hn
u minh thượng|u.m.thượng	kiên giang|k.giang
châu thành|c.thành	an giang
bình tân|b.tân|bt	hồ chí minh|hcm
tam điệp|t.điệp	ninh bình|n.bình
tam đảo|t.đảo	vĩnh phúc|v.phúc
si ma cai|s.m.cai	lào cai|l.cai
mộ đức	quảng ngãi|q.ngãi
phong điền|p.điền	cần thơ|c.thơ
châu đức|c.đức	bà rịa vũng tàu|bà rịa|vũng tàu|b.rịa v.tàu
tủa chùa|t.chùa	điện biên|đ.biên
yên phong|y.phong	bắc ninh|b.ninh
quảng điền|q.điền	thừa thiên huế|tt huế|tth
châu đốc|c.đốc	an giang
hà đông|hđ	hà nội|hn
ngọc lặc|n.lặc	thanh hóa|t.hóa
vị thủy	hậu giang|h.giang
kim bảng|k.bảng	hà nam|h.nam
hương khê|h.khê	hà tĩnh|h.tĩnh
tân biên|t.biên	tây ninh|t.ninh
ninh hòa|n.hòa	khánh hòa|k.hòa
vũ thư	thái bình|t.bình
nậm pồ|n.pồ	điện biên|đ.biên
đắk glei|đ.glei	kon tum|k.tum
trảng bàng|t.bàng	tây ninh|t.ninh
thạch hà|t.hà	hà tĩnh|h.tĩnh
bù gia mập|b.g.mập	bình phước|b.phước
cẩm mỹ|c.mỹ	đồng nai|đ.nai
cần đước|c.đước	long an|l.an
quận 10|10|q10	hồ chí minh|hcm
ý yên	nam định|n.định
kiến an|k.an|ka	hải phòng|hp
vĩnh thạnh|v.thạnh	bình định|b.định
tân phú|t.phú	đồng nai|đ.nai
phú riềng|p.riềng	bình phước|b.phước
kbang	gia lai|g.lai
bình sơn|b.sơn	quảng ngãi|q.ngãi
krông pắc|k.pắc	đắk lắk|đ.lắk
than uyên|t.uyên	lai châu|l.châu
ba bể	bắc kạn|b.kạn
yên lạc|y.lạc	vĩnh phúc|v.phúc
quỳnh phụ|q.phụ	thái bình|t.bình
a lưới	thừa thiên huế|tt huế|tth
sơn la|s.la	sơn la
phù cừ|p.cừ	hưng yên|h.yên
nam đông|n.đông	thừa thiên huế|tt huế|tth
hà giang	hà giang|h.giang
văn yên|v.yên	yên bái|y.bái
đăk glong|đ.glong	đắk nông|đ.nông
thạch thành|t.thành	thanh hóa|t.hóa
ia grai	gia lai|g.lai
hải hà|h.hà	quảng ninh|q.ninh
mỹ tú	sóc trăng|s.trăng
tân châu|t.châu	tây ninh|t.ninh
phủ lý|p.lý	hà nam|h.nam
hòa vang|h.vang|hv	đà nẵng|đn
châu thành a|c.t.a	hậu giang|h.giang
nông cống|n.cống	thanh hóa|t.hóa
thanh bình|t.bình	đồng tháp|đ.tháp
sơn động|s.động	bắc giang|b.giang
pleiku	gia lai|g.lai
chi lăng|c.lăng	lạng sơn|l.sơn
nga sơn|n.sơn	thanh hóa|t.hóa
kon plông|k.plông	kon tum|k.tum
hoa lư|h.lư	ninh bình|n.bình
dương minh châu|d.m.châu	tây ninh|t.ninh
hà quảng	cao bằng|c.bằng
nam đàn|n.đàn	nghệ an
hướng hóa|h.hóa	quảng trị|q.trị
ea h'leo	đắk lắk|đ.lắk
tân thạnh|t.thạnh	long an|l.an
đại từ|đ.từ	thái nguyên|t.nguyên
quang bình|q.bình	hà giang|h.giang
thường tín|t.tín|tt	hà nội|hn
nghĩa hưng|n.hưng	nam định|n.định
phú quý|p.quý	bình thuận|b.thuận
nậm nhùn|n.nhùn	lai châu|l.châu
đầm hà|đ.hà	quảng ninh|q.ninh
hàm yên|h.yên	tuyên quang|t.quang
sơn trà|s.trà|st	đà nẵng|đn
an biên	kiên giang|k.giang
từ sơn	bắc ninh|b.ninh
mù cang chải|m.c.chải	yên bái|y.bái
văn lâm|v.lâm	hưng yên|h.yên
kim bôi|k.bôi	hòa bình|h.bình
sơn tây|s.tây	quảng ngãi|q.ngãi
văn bàn|v.bàn	lào cai|l.cai
quỳ châu|q.châu	nghệ an
kiên lương|k.lương	kiên giang|k.giang
phan thiết|p.thiết	bình thuận|b.thuận
như thanh|n.thanh	thanh hóa|t.hóa
gia lâm|g.lâm|gl	hà nội|hn
bắc hà|b.hà	lào cai|l.cai
lạc thủy|l.thủy	hòa bình|h.bình
đạ tẻh	lâm đồng|l.đồng
hưng yên|h.yên	hưng yên|h.yên
vĩnh thuận|v.thuận	kiên giang|k.giang
càng long|c.long	trà vinh|t.vinh
thọ xuân|t.xuân	thanh hóa|t.hóa
văn quan|v.quan	lạng sơn|l.sơn
an dương|ad	hải phòng|hp
lộc hà|l.hà	hà tĩnh|h.tĩnh
ân thi	hưng yên|h.yên
gò công đông|g.c.đông	tiền giang|t.giang
tiên yên|t.yên	quảng ninh|q.ninh
thái nguyên|t.nguyên	thái nguyên|t.nguyên
đức phổ|đ.phổ	quảng ngãi|q.ngãi
vị xuyên	hà giang|h.giang
hạ hòa	phú thọ|p.thọ
vĩnh lợi|v.lợi	bạc liêu|b.liêu
krông năng|k.năng	đắk lắk|đ.lắk
châu thành|c.thành	kiên giang|k.giang
quảng ninh|q.ninh	quảng bình|q.bình
hoài ân|h.ân	bình định|b.định
chương mỹ|c.mỹ|cm	hà nội|hn
nho quan|n.quan	ninh bình|n.bình
thanh liêm|t.liêm	hà nam|h.nam
hương trà|h.trà	thừa thiên huế|tt huế|tth
tri tôn|t.tôn	an giang
quận 4|4|q4	hồ chí minh|hcm
hồng dân|h.dân	bạc liêu|b.liêu
đức huệ|đ.huệ	long an|l.an
vĩnh tường|v.tường	vĩnh phúc|v.phúc
đồ sơn|đs	hải phòng|hp
tây ninh|t.ninh	tây ninh|t.ninh
phong thổ|p.thổ	lai châu|l.châu
buôn ma thuột|b.m.thuột	đắk lắk|đ.lắk
tân uyên|t.uyên	bình dương|b.dương
chợ mới|c.mới	an giang
sơn dương|s.dương	tuyên quang|t.quang
mường la|m.la	sơn la
buôn đôn|b.đôn	đắk lắk|đ.lắk
long thành|l.thành	đồng nai|đ.nai
ngọc hiển|n.hiển	cà mau|c.mau
cẩm phả|c.phả	quảng ninh|q.ninh
vạn ninh|v.ninh	khánh hòa|k.hòa
đồng hới|đ.hới	quảng bình|q.bình
ngã năm|n.năm	sóc trăng|s.trăng
phù cát|p.cát	bình định|b.định
điện bàn|đ.bàn	quảng nam|q.nam
phú vang|p.vang	thừa thiên huế|tt huế|tth
bình tân|b.tân	vĩnh long|v.long
hoằng hóa|h.hóa	thanh hóa|t.hóa
sơn tây|s.tây|st	hà nội|hn
bảo lạc|b.lạc	cao bằng|c.bằng
hà tĩnh	hà tĩnh|h.tĩnh
hậu lộc|h.lộc	thanh hóa|t.hóa
ngã bảy|n.bảy	hậu giang|h.giang
vĩnh thạnh|v.thạnh	cần thơ|c.thơ
lạng giang|l.giang	bắc giang|b.giang
quận 12|12|q12	hồ chí minh|hcm
khoái châu|k.châu	hưng yên|h.yên
đan phượng|đ.phượng|đp	hà nội|hn
phú tân|p.tân	cà mau|c.mau
quế sơn|q.sơn	quảng nam|q.nam
giá rai|g.rai	bạc liêu|b.liêu
giồng riềng|g.riềng	kiên giang|k.giang
lấp vò|l.vò	đồng tháp|đ.tháp
gia bình|g.bình	bắc ninh|b.ninh
quảng trị|q.trị	quảng trị|q.trị
chí linh|c.linh	hải dương|h.dương
chợ gạo|c.gạo	tiền giang|t.giang
nhơn trạch|n.trạch	đồng nai|đ.nai
giồng trôm|g.trôm	bến tre|b.tre
bàu bàng|b.bàng	bình dương|b.dương
hồng lĩnh|h.lĩnh	hà tĩnh|h.tĩnh
kiến thụy|k.thụy|kt	hải phòng|hp
na rì	bắc kạn|b.kạn
an khê	gia lai|g.lai
hội an|h.an	quảng nam|q.nam
trà vinh|t.vinh	trà vinh|t.vinh
vĩnh linh|v.linh	quảng trị|q.trị
châu phú|c.phú	an giang
hương sơn|h.sơn	hà tĩnh|h.tĩnh
tràng định|t.định	lạng sơn|l.sơn
tương dương|t.dương	nghệ an
phú tân|p.tân	an giang
cẩm lệ|c.lệ|cl	đà nẵng|đn
đông triều|đ.triều	quảng ninh|q.ninh
ba đồn	quảng bình|q.bình
sa đéc	đồng tháp|đ.tháp
trấn yên|t.yên	yên bái|y.bái
vĩnh yên|v.yên	vĩnh phúc|v.phúc
tiền hải|t.hải	thái bình|t.bình
vĩnh bảo|v.bảo|vb	hải phòng|hp
cửa lò|c.lò	nghệ an
bắc bình|b.bình	bình thuận|b.thuận
bác ái|b.ái	ninh thuận|n.thuận
bắc giang|b.giang	bắc giang|b.giang
yên châu|y.châu	sơn la
tân châu|t.châu	an giang
hoàng mai|h.mai	nghệ an
đăk đoa|đ.đoa	gia lai|g.lai
tây trà|t.trà	quảng ngãi|q.ngãi
yên thủy|y.thủy	hòa bình|h.bình
quỳ hợp|q.hợp	nghệ an
mang yang|m.yang	gia lai|g.lai
thanh thủy|t.thủy	phú thọ|p.thọ
hóc môn|h.môn|hm	hồ chí minh|hcm
minh hóa|m.hóa	quảng bình|q.bình
bảo lộc|b.lộc	lâm đồng|l.đồng
khánh sơn|k.sơn	khánh hòa|k.hòa
ngũ hành sơn|n.h.sơn|nhs	đà nẵng|đn
nghĩa lộ|n.lộ	yên bái|y.bái
cô tô	quảng ninh|q.ninh
bình long|b.long	bình phước|b.phước
lạng sơn|l.sơn	lạng sơn|l.sơn
long xuyên|l.xuyên	an giang
liên chiểu|l.chiểu|lc	đà nẵng|đn
thuận an|t.an	bình dương|b.dương
sóc trăng|s.trăng	sóc trăng|s.trăng
trần đề|t.đề	sóc trăng|s.trăng
kim thành|k.thành	hải dương|h.dương
châu thành|c.thành	tây ninh|t.ninh
lý nhân	hà nam|h.nam
kim động|k.động	hưng yên|h.yên
ea súp	đắk lắk|đ.lắk
tân yên|t.yên	bắc giang|b.giang
cẩm xuyên|c.xuyên	hà tĩnh|h.tĩnh
thốt nốt|t.nốt	cần thơ|c.thơ
yên dũng|y.dũng	bắc giang|b.giang
thuận nam|t.nam	ninh thuận|n.thuận
nghĩa hành|n.hành	quảng ngãi|q.ngãi
bến cát|b.cát	bình dương|b.dương
văn lãng|v.lãng	lạng sơn|l.sơn
bình lục|b.lục	hà nam|h.nam
sơn tịnh|s.tịnh	quảng ngãi|q.ngãi
tiểu cần|t.cần	trà vinh|t.vinh
quan hóa|q.hóa	thanh hóa|t.hóa
kiên hải|k.hải	kiên giang|k.giang
quản bạ|q.bạ	hà giang|h.giang
an lão	bình định|b.định
mỏ cày bắc|m.c.bắc	bến tre|b.tre
diễn châu|d.châu	nghệ an
ia h' drai	kon tum|k.tum
yên khánh|y.khánh	ninh bình|n.bình
tân phú đông|t.p.đông	tiền giang|t.giang
lắk	đắk lắk|đ.lắk
dầu tiếng|d.tiếng	bình dương|b.dương
thủ đức|t.đức|tđ	hồ chí minh|hcm
vinh	nghệ an
củ chi|cc	hồ chí minh|hcm
chơn thành|c.thành	bình phước|b.phước
gio linh|g.linh	quảng trị|q.trị
ngọc hồi|n.hồi	kon tum|k.tum
quan sơn|q.sơn	thanh hóa|t.hóa
vĩnh châu|v.châu	sóc trăng|s.trăng
châu thành|c.thành	sóc trăng|s.trăng
đức cơ|đ.cơ	gia lai|g.lai
cam ranh|c.ranh	khánh hòa|k.hòa
hồng bàng|h.bàng|hb	hải phòng|hp
tuần giáo|t.giáo	điện biên|đ.biên
tam nông|t.nông	đồng tháp|đ.tháp
quảng uyên|q.uyên	cao bằng|c.bằng
tam kỳ|t.kỳ	quảng nam|q.nam
núi thành|n.thành	quảng nam|q.nam
xuân lộc|x.lộc	đồng nai|đ.nai
ngô quyền|n.quyền|nq	hải phòng|hp
huế	thừa thiên huế|tt huế|tth
bạch thông|b.thông	bắc kạn|b.kạn
cẩm giàng|c.giàng	hải dương|h.dương
ea kar	đắk lắk|đ.lắk
thạnh trị|t.trị	sóc trăng|s.trăng
quận 6|6|q6	hồ chí minh|hcm
sầm sơn|s.sơn	thanh hóa|t.hóa
nam định|n.định	nam định|n.định
krông búk|k.búk	đắk lắk|đ.lắk
nông sơn|n.sơn	quảng nam|q.nam
hoài đức|h.đức|hđ	hà nội|hn
lục nam|l.nam	bắc giang|b.giang
nghi xuân|n.xuân	hà tĩnh|h.tĩnh
sóc sơn|s.sơn|ss	hà nội|hn
an minh	kiên giang|k.giang
duyên hải|d.hải	trà vinh|t.vinh
kon rẫy|k.rẫy	kon tum|k.tum
đầm dơi|đ.dơi	cà mau|c.mau
cát tiên|c.tiên	lâm đồng|l.đồng
gò vấp|gv	hồ chí minh|hcm
tân hiệp|t.hiệp	kiên giang|k.giang
tân lạc|t.lạc	hòa bình|h.bình
đoan hùng|đ.hùng	phú thọ|p.thọ
bình liêu|b.liêu	quảng ninh|q.ninh
phú lộc|p.lộc	thừa thiên huế|tt huế|tth
ba vì|bv	hà nội|hn
lý sơn	quảng ngãi|q.ngãi
bắc yên|b.yên	sơn la
quận 7|7|q7	hồ chí minh|hcm
văn giang|v.giang	hưng yên|h.yên
phúc yên|p.yên	vĩnh phúc|v.phúc
yên định|y.định	thanh hóa|t.hóa
văn chấn|v.chấn	yên bái|y.bái
triệu sơn|t.sơn	thanh hóa|t.hóa
trà bồng|t.bồng	quảng ngãi|q.ngãi
cờ đỏ	cần thơ|c.thơ
bến cầu|b.cầu	tây ninh|t.ninh
vũ quang	hà tĩnh|h.tĩnh
bến tre|b.tre	bến tre|b.tre
thông nông|t.nông	cao bằng|c.bằng
cẩm khê|c.khê	phú thọ|p.thọ
cam lộ|c.lộ	quảng trị|q.trị
tây giang|t.giang	quảng nam|q.nam
yên minh|y.minh	hà giang|h.giang
hiệp hòa|h.hòa	bắc giang|b.giang
hương thủy|h.thủy	thừa thiên huế|tt huế|tth
tam bình|t.bình	vĩnh long|v.long
kon tum|k.tum	kon tum|k.tum
bắc trà my|b.t.my	quảng nam|q.nam
vĩnh lộc|v.lộc	thanh hóa|t.hóa
kỳ anh	hà tĩnh|h.tĩnh
tuy đức|t.đức	đắk nông|đ.nông
vân hồ|v.hồ	sơn la
kim sơn|k.sơn	ninh bình|n.bình
an nhơn	bình định|b.định
phú giáo|p.giáo	bình dương|b.dương
hàm thuận nam|h.t.nam	bình thuận|b.thuận
tân hưng|t.hưng	long an|l.an
ba tri	bến tre|b.tre
phù yên|p.yên	sơn la
lạc dương|l.dương	lâm đồng|l.đồng
thanh trì|t.trì|tt	hà nội|hn
trường sa|t.sa	khánh hòa|k.hòa
biên hòa|b.hòa	đồng nai|đ.nai
tam dương|t.dương	vĩnh phúc|v.phúc
cầu giấy|c.giấy|cg	hà nội|hn
điện biên đông|đ.b.đông	điện biên|đ.biên
đất đỏ|đ.đỏ	bà rịa vũng tàu|bà rịa|vũng tàu|b.rịa v.tàu
lào cai|l.cai	lào cai|l.cai
cà mau	cà mau|c.mau
kinh môn|k.môn	hải dương|h.dương
từ liêm|bắc từ liêm|tl|btl	hà nội|hn
lệ thủy	quảng bình|q.bình
mường lát|m.lát	thanh hóa|t.hóa
quế phong|q.phong	nghệ an
mỹ đức|mđ	hà nội|hn
lương sơn|l.sơn	hòa bình|h.bình
đam rông|đ.rông	lâm đồng|l.đồng
phong điền|p.điền	thừa thiên huế|tt huế|tth
quảng trạch|q.trạch	quảng bình|q.bình
yên thế|y.thế	bắc giang|b.giang
phù ninh|p.ninh	phú thọ|p.thọ
cao bằng|c.bằng	cao bằng|c.bằng
hà đông	hà tây|h.tây
sơn tây|s.tây	hà tây|h.tây
ba vì	hà tây|h.tây
phúc thọ|p.thọ	hà tây|h.tây
thạch thất|t.thất	hà tây|h.tây
quốc oai|q.oai	hà tây|h.tây
chương mỹ|c.mỹ	hà tây|h.tây
đan phượng|đ.phượng	hà tây|h.tây
Hoài đức|H.đức	hà tây|h.tây
thanh oai|t.oai	hà tây|h.tây
mỹ đức	hà tây|h.tây
ứng hoà|ứ.hoà	hà tây|h.tây
thường tín|t.tín	hà tây|h.tây
phú xuyên|p.xuyên	hà tây|h.tây
